WWWWWWWWWW
WFDFFFFFFW
WFFFFFFFFW
WFFFFFCFFW
WFFFFFFFPW
WFFFFFFFFW
WFFCFFFFFW
WFFFFFFFFW
WFFDFFFFFW
WWWWWWWWWW