WWWWWWWWWW
WFFFWFFFFW
WFDFWFFFFW
WFFPWFFFFW
WFFFCFFFFW
WFFFFFFFFW
WFFFWFCFFW
WFFFWFFWFW
WFFWFFFFDW
WWWWWWWWWW