WWWWWWWWWW
WDFFWWWWWW
WWCFFWWWWW
WWFFFWWWWW
WWFFFWWWWW
WWFFPFFFFW
WWFFFFFFFW
WFFFCFFFDW
WFFFFFFFFW
WWWWWWWWWW